NO pics/eagle.png
SO pics/greystone.png
WE pics/tree.png
EA pics/greystone.png


F 34,123,255
C 7,8,123

        1111111111111111111111111
        1000000000110000000000001
        1011000001110000000000001
        1001000000000000000000001
111111111011000001110000000000001
100000000000000001111111111111111
11110111111111011100000010001
11110111111111N11101010000001
11000000110101011100000010001
10000000000000001000000010001
10000000000000000001010010001
110000011101010111110111100111
11110111 1110101 100000000001
11111111 1111111 111111111111








